#####    #####
##### P      #
####     ##  #
 OO# #   ## ##
     X    #X##
#  # #      ##
####     # X##
##########   #
####O        #
##############
##############
##############
