######
#  P #
# O  #
#  X #
#    #
######
