#########
#     P #
#  O    #
#     X #
# O#X   #
#       #
#########
