########
#      #
#  ##  #
# #  # #
# X  O #
#  XO  #
# X  O #
# #  # #
#  ##  #
#P     #
########
