##########
#  ###   #
#  #O#   #
#  # #####
####X XO##
##O XP####
#####X#  #
#   #O#  #
#   ###  #
##########
