###############
######  #######
######OX#######
######  #######
######  #######
# O         O #
# X   P     X #
######  #######
######OX#######
######  #######
###############
###############
