###############
#      OX O   #
##### ##X###  #
#  O#        O#
#             #
## ####P##X####
# X#O         #
#             #
##X###X### #  #
#O            #
###############
