###############
#    #     # O#
# #X #     #  #
# X  #     # O#
### ##     #  #
#            O#
# #    P      #
# X  #     # O#
# X X#     #  #
#    #     # O#
###############
