############
#O OO#     #
# #  # XX# #
###  #   X #
##   ### X #
##     P   #
#        # #
# ###    # #
#        # #
#O  #    # #
############
