###############
#  #O#        #
#    #        #
#  #O#        #
#    ##########
#  #OO PX     #
#  #   #   X  #
#  ### #  #  ##
#       X #X  #
#             #
###############
